##########
#b  X   X#
#     C  #
# p b  P #
#        #
#  C gggt#
#  t     #
#  C  O# #
#  X   #E#
##########
