OOOO######
OOOO#Ot#X#
OOOO#Og#g#
OOOO#Og#g#
#####Og C#
#    OO %#
#  t  OPm#
#  C  O  #
#  X  O E#
##########